~~~~~~~~## ###~~~~~~#
~####~~~~~ ~~~~~~~#~#
~~~~~~~~#~ ~~~##~~~~#
~#~~~~~~~~ ~~~~~~~~~#
~#~~~~~#~~ #~~~~~~#~~
~#~~#~~#~~ ~~~~#~~~~#
~~~~~~~~~~ ~~~~#~~~~#
~~~##~~~~# #~~~#~~~~~
~~~~~~~~~~ ~~~~~~~~~~
~~~~#~~### ~~~~##~~~~